##############################
##***#######*######**********$
####*#######********##########
####*#######*#################
##****#####*********##########
#####*########*####**********#
#####**********#############*#
o*****######################*#
####################*********#
##############################